name	synonym
あかうお	['アカウオ', '赤さかな', '赤魚']
あさり	['アサリ', '浅蜊', '蛤仔', '鯏']
あんかけ焼きそば	['あんかけやきそば', 'あんかけ焼き蕎麦']
あんこう	['あんきも', 'あん肝', 'アンキモ', 'アンコウ', '鮟鱇']
あんず	['アプリコット', 'アンズ', 'カラモモ', '唐桃', '杏', '杏子']
いなり寿司	['稲荷すし', '稲荷寿司']
うどん	['いなにわうどん', 'きしめん', 'さぬきうどん', 'ウドン', '稲庭うどん', '稲庭饂飩', '讃岐うどん', '讃岐饂飩', '饂飩']
うり	['いとうり', 'かりもり', 'きんしうり', 'しろうり', 'そうめんかぼちゃ', 'そうめん瓜', 'とうがん', 'はぐらうり', 'はぐら瓜', 'はやとうり', 'はやと瓜', 'へちま', 'まくわうり', 'ゆうごう', 'ウリ', 'キンシウリ', 'シロウリ', 'トウガン', 'ナーベーラー', 'ハヤトウリ', 'ハヤト瓜', 'パスタ瓜', 'ヘチマ', 'マクワウリ', 'マーウイ', 'ミニとうがん', 'ミニ冬瓜', 'モーウィ', '冬瓜', '堅瓜', '夕顔', '天糸瓜', '姫冬瓜', '瓜', '白うり', '白瓜', '糸瓜', '赤うり', '赤瓜', '金糸瓜', '隼人瓜', '青うり', '青瓜']
えのき	['えのきたけ', 'えのきだけ', 'えのき茸', 'なめすすき', 'なめたけ', 'なめ茸', 'ゆきのした', 'エノキ', 'エノキタケ', 'エノキダケ', 'エノキ茸', 'ナメススキ', 'ナメタケ', 'ナメ茸', 'ブラウンえのき', 'ユキノシタ', 'ワイルドえのき', '山茶茸', '榎']
えんどう豆	['うすいえんどう豆', 'えんどうまめ', 'エンドウマメ', 'エンドウ豆', 'グリンピース', 'グリーンピース', 'モロッコエンドウ豆']
おかゆ	['お粥', 'かゆ', 'がゆ', 'がゆ〜', '粥']
おから	['おからパウダー', 'オカラ', '卯の花']
おにぎり	['おにぎり〜', 'おにぎり〜〜', 'おにぎりぃ', 'おにぎりー', 'おむすび', 'お握り', 'オニギリ']
おはぎ	['ぉはぎ', 'お萩']
お好み焼き	['おこのみやき', 'おこのみ焼き', 'お好み焼き〜', 'お好み焼きー', 'お好み焼きーー']
お漬物	['おつけもの', 'おつけ物', 'お漬けもの', 'お漬け物', 'お漬もの', '御漬物']
かじき	['かじきまぐろ', 'まかじき', 'めかじき', 'カジキ', 'カジキまぐろ', 'カジキマグロ', 'マカジキ', 'メカジキ', '旗魚', '梶木', '舵木']
かつお節	['おかか', 'かつおぶし', 'オカカ', 'カツオブシ', 'カツオ節', '削り節', '花かつお', '花カツオ', '花鰹', '鰹節']
かに	['カニ', '蟹']
かぶ	['かぶら', 'こかぶ', 'カブ', 'コカブ', '小かぶ', '小カブ', '小蕪', '蕪', '赤かぶ', '赤カブ']
かぼちゃのサラダ	['かぼちゃサラダ', 'カボチャのサラダ', 'カボチャサラダ', 'カボチャサラダー', '南瓜のサラダ', '南瓜サラダ']
かぼちゃのポタージュ	['カボチャのポタージュ', '南瓜のポタージュ']
かぼちゃの煮物	['かぼちゃの煮もの', 'カボチャの煮もの', 'カボチャの煮物', '南瓜の煮もの...', '南瓜の煮物']
かぼちゃコロッケ	['カボチャコロッケ', '南瓜コロッケ']
かぼちゃスープ	['かぼちゃのスープ', 'カボチャのスープ', 'カボチャスープ', '南瓜のスープ', '南瓜スープ']
かぼちゃプリン	['カボチャプリン', '南瓜プリン']
かんぴょう	['乾ぴょう', '乾瓢', '干ぴょう', '干瓢']
きくらげ	['キクラゲ', '木くらげ', '木クラゲ', '木耳', '白きくらげ', '白キクラゲ', '白木耳']
きす	['キス', '鱚', '鼠頭魚']
きな粉	['うぐいすきなこ', 'うぐいすきな粉', 'うぐいす粉', 'うぐいす黄な粉', 'うぐいす黄粉', 'きなこ', '青きなこ', '青きな粉', '青黄な粉', '青黄粉', '黄な粉', '黄粉']
きゅうりの酢の物	['きゅうりのすのもの', 'きゅうりの酢のもの', 'きゅーりの酢の物']
きんかん	['きんきつ', 'キンカン', 'キンキツ', '金柑', '金橘']
きんときまめ	['きんとき豆', 'キドニービーンズ', 'レッドキドニー', 'レッドキドニービーンズ', '大正金時', '大正金時豆', '金時豆']
きんぴら	['きんぴら〜', 'きんぴらー', 'キンピラ']
きんぴらごぼう	['きんぴらゴボウ', 'きんぴら牛蒡', 'キンピラごぼう', 'キンピラ牛蒡']
きんめだい	['きんめ', 'キンメ', 'キンメダイ', 'キンメ鯛', '金目', '金目鯛']
くうしんさい	['あさがお菜', 'アサガオナ', 'エンサイ', 'クウシンサイ', '朝顔菜', '空芯菜']
くわい	['クワイ', 'ミニくわい', '慈姑']
こんにゃく	['こんにゃく発表', 'しらたき', 'つきこんにゃく', 'つきコンニャク', 'コンニャク', 'シラタキ', 'ツキコンンヤク', '刺身こんにゃく', '刺身コンニャク', '板こんにゃく', '板コンニャク', '玉こんにゃく', '玉コンニャク', '白滝', '糸こん', '糸こんにゃく', '糸コン', '糸コンニャク', '蒟蒻']
ごぼうサラダ	['ごぼうサラダ〜', 'ゴボウサラダ', '牛蒡サラダ']
ごま	['ゴマ', '白ごま', '白ゴマ', '白胡麻', '胡麻', '金ごま', '金ゴマ', '金胡麻', '黒ごま', '黒ゴマ', '黒胡麻']
ご飯	['ごは〜ん', 'ごはん', 'ごはん〜', 'ごはーん', 'ゴハン', '御飯']
ささげ	['いんげん', 'ささきインゲン', 'ささぎ', 'ささげインゲン', 'さやいんげん', 'さやインゲン', 'インゲン', 'ササギ', 'ササゲ', 'モロッコいんげん', 'モロッコインゲン', '十六ささげ', '十六ササゲ', '隠元']
さつまいも	['さつま芋', 'サツマイモ', '安納芋', '焼き芋', '紫芋', '薩摩芋']
さばの味噌煮	['さばのみそ煮', 'サバのみそ煮', 'サバの味噌煮', '鯖のみそ煮', '鯖の味噌煮']
さやえんどう	['えんどう', 'きぬさや', 'エンドウ', 'キヌサヤ', 'サヤエンドウ', '絹さや', '絹サヤ']
ししゃも	['からふとししゃも', 'カラフトシシャモ', 'シシャモ', '柳葉魚', '樺太柳葉魚']
しじみ	['シジミ', '蜆']
しめじ	['はたけしめじ', 'はたけシメジ', 'ひらたけ', 'ふなしめじ', 'ぶなしめじ', 'シメジ', 'ハタケシメジ', 'ヒラタケ', 'フナシメジ', 'ブナしめじ', 'ブナしめじー', 'ブナシメジ', 'ブナピー', 'ホワイトしめじ', 'ホワイトシメジ', '平茸', '白しめじ', '白シメジ', '紫しめじ', '紫シメジ']
しょうが焼き	['しょうがやき', 'しょーが焼き', '生姜焼き', '生姜焼き〜', '生姜焼きー']
しらす	['かまあげしらす', 'じゃこ', 'ちりめんじゃこ', 'ちりめんジャコ', 'ちりめん雑魚', 'シラス', 'ジャコ', 'チリメンじゃこ', 'チリメンジャコ', 'チリメン雑魚', '白子', '縮緬雑魚', '釜あげしらす', '釜揚げしらす']
しるこ	['じるこ', '汁粉']
すし酢	['寿司酢']
すだち	['かぼす', 'カボス', 'シークヮーサ−', 'シークワーサー', 'スダチ', 'ライム', '臭橙', '酢橘', '香母酢']
せり	['セリ', '芹', '野ぜり']
せんべい	['せんべぃ', 'せんべい〜', 'せんべー', '煎餅']
ぜんざい	['善哉']
ぜんまい	['ゼンマイ', '薇']
そうめん	['そ〜めん', 'そうめん〜', 'そーうめん', 'そーめん', 'ぞうめん', 'ぞーめん', 'ひやむぎ', 'ふしめん', 'ソ...', 'ソーメン', '冷麦', '半田麺', '節麺', '素麺']
そば	['ソバ', '茶そば', '茶ソバ', '茶蕎麦', '蕎麦']
そぼろ	['そぼろ〜', 'ソボロ']
そら豆	['そらまめ', 'ソラマメ', '空豆', '赤そら豆']
たけのこご飯	['たけのこ御飯', 'タケノコご飯', 'タケノコ御飯', '竹の子ご飯', '竹の子御飯', '筍ご飯', '筍御飯']
たこ焼き	['たこやき', 'たこ焼', 'タコ焼き']
だし	['いりこだし', 'いりこダシ', 'いりこ出汁', 'うどんだし', 'うどんダシ', 'うどん出汁', 'かつおだし', 'かつおダシ', 'かつお出し', 'かつお出汁', 'こんぶだし', 'こんぶダシ', 'こんぶ出汁', 'だしのもと', 'だしの素', 'だし汁', 'ほんだし', 'カツオだし', 'カツオダシ', 'カツオ出汁', 'ダシ', 'ダシのもと', 'ダシの素', 'ダシ汁', 'ホンだし', '一番だし', '一番ダシ', '一番出汁', '二番だし', '二番ダシ', '二番出汁', '出し汁', '出汁', '出汁のもと', '出汁の素', '出汁汁', '和風だし', '和風ダシ', '和風出汁', '昆布だし', '昆布ダシ', '昆布出汁', '昆布茶', '白だし', '白ダシ', '白出汁', '鰹だし', '鰹ダシ', '鰹出汁']
ちらし寿司	['ちらし', 'ちらし〜', 'ちらしすし', '散らし', '散らし寿司']
ちらし寿司の素	['ちらし寿司のもと']
つぶ貝	['つぶ', 'ツブ', 'ツブ貝', 'マツブ', '灯台つぶ', '灯台ツブ', '真つぶ', '真つぶ貝', '真ツブ', '磯つぶ', '磯つぶ貝', '磯ツブ', '螺', '青つぶ']
とうみょう	['豆苗']
どら焼き	['どらやき', 'どら焼き〜', 'ドラやき', 'ドラ焼き']
なすの味噌炒め	['なすのみそ炒め', 'ナスのみそ炒め', 'ナスの味噌炒め', '茄子のみそ炒...', '茄子の味噌炒め']
なまこ	['ナマコ', '海鼠', '赤なまこ']
なめこ	['おっきーなめこ', 'オッキーなめこ', 'ナメコ', '滑子']
なめたけ	['なめたけ〜', 'なめ茸']
にゅうめん	['にゅうめん〜', 'にゅう麺']
にんじんサラダ	['ニンジンサラダ', '人参サラダ']
はっさく	['ハッサク', '八朔']
はまぐり	['ハマグリ', 'ホンビノスガイ', 'ホンビノス貝', '大あさり', '大アサリ', '蛤']
ぱん	['ぱん〜', 'ぱーん']
ひじき	['ヒジキ', '羊栖菜', '芽ひじき', '鹿尾菜']
ひじきの煮物	['ひじきの煮もの', 'ヒジキの煮物']
ひよこ豆	['ひよこまめ', 'ひよこマメ', 'エジプトまめ', 'エジプトマメ', 'エジプト豆', 'ガルバンソ', 'ガルバンゾ', 'ガルバンゾー', 'ヒヨコマメ', 'ヒヨコ豆']
ふき	['ふきのとう', 'フキ', 'フキノトウ', '款冬', '苳', '菜蕗', '蕗']
ぶり大根	['ブリ大根', '鰤大根']
ほうれん草	['ちぢみほうれん草', 'ほうれんそう', 'サラダほうれん草', 'サラダホウレン草', 'スライスホウレン草', 'ベビーほうれん草', 'ホウレンソウ', 'ホウレン草', 'ホーレン草', '法蓮草']
ほうれん草の胡麻和え	['ほう...', 'ほうれん草のごまあえ', 'ほうれん草のごま和え', 'ほうれん草のゴマ和え']
ほっき貝	['ほっき', 'ウバガイ', 'ホッキ', 'ホッキガイ', 'ホッキ貝', '北寄', '北寄貝', '姥貝']
ほっけ	['しまほっけ', 'シマホッケ', 'ホッケ', '姫ほっけ', '姫ホッケ', '真ほっけ', '真ホッケ', '縞ほっけ', '縞ホッケ']
まいたけ	['マイタケ', '白まいたけ', '白マイタケ', '白舞茸', '舞茸']
まつたけ	['マツタケ', '松茸']
まんじゅう	['まんじゅう〜', '饅頭']
みりん	['ミリン', '味醂', '本みりん', '本ミリン', '本味醂', '白みりん', '白ミリン', '白味醂']
むかご	['ムカゴ']
めばる	['ほごメバル', 'キメバル', 'メバル', '眼張', '眼張魚', '鮴']
めんつゆ	['うどんつゆ', 'うどんツユ', 'かつおつゆ', 'かつおツユ', 'こんぶつゆ', 'こんぶツユ', 'そばつゆ', 'そばツユ', 'だしつゆ', 'だしツユ', 'つゆ', 'つゆの素', 'カツオつゆ', 'カツオツユ', 'ダシつゆ', 'ダシツユ', 'ツユ', 'ツユの素', '万能つゆ', '万能ツユ', '出汁つゆ', '出汁ツユ', '昆布つゆ', '昆布ツユ', '蕎麦つゆ', '蕎麦ツユ', '鰹つゆ', '鰹ツユ', '麺つゆ', '麺ツユ', '麺露']
もずく	['モズク', '水雲', '海蘊', '藻付']
もやし	['モヤシ', '大豆もやし', '大豆モヤシ', '太もやし', '太モヤシ', '緑豆もやし', '緑豆モヤシ', '豆もやし', '豆モヤシ']
もやしのナムル	['もやしのナムル', 'もやしナムル']
ゆず	['ユズ', '柚子', '青ゆず']
ゆで卵	['ゆでたまご', 'ゆでたまご〜', '茹でたまご', '茹で卵']
ようかん	['羊かん', '羊羮', '羊羹']
らっきょう	['エシャレット', 'エシャロット', 'ラッキョウ', '島らっきょ', '島らっきょう', '島ラッキョウ', '薤', '辣韭', '辣韮']
れんこん	['レンコン', '蓮根']
れんこんのきんぴら	['れんこんのキンピ...', 'レンコンのきんぴら', 'レンコンのキンピラ', '蓮根のきんぴら']
わさび菜	['からし菜', 'わさびな', 'サラダわさび菜', 'ワサビナ', 'ワサビ菜', '葉わさび']
わらび餅	['わらびもち', '蕨もち', '蕨餅']
アイスクリーム	['アイス', 'アイスクリーム', 'カスタードアイス', 'カスタードアイスクリーム', 'クリームアイス', 'クリームアイスクリーム', 'チョコアイス', 'チョコアイスクリーム', 'チョコレートアイス', 'チョコレートアイスクリーム', 'バニラアイス', 'バニラアイスクリーム', '抹茶アイス', '抹茶アイスクリーム']
アジの南蛮漬け	['あじの南蛮漬', 'あじの南蛮漬け', 'アジの南蛮漬', '鰺の南蛮漬け']
アスパラガス	['アスパラ', 'グリーンアスパラ', 'グリーンアスパラガス', 'ホワイトアスパラ', 'ホワイトアスパラガス', 'ミニアスパラ']
アナゴ	['あなご', '海鰻', '海鰻&#40058;', '穴子']
アボカド	['アボガド']
アユ	['あゆ', '年魚', '香魚', '鮎']
アロエ	['あろえ']
アワビ	['あわび', '鮑']
イカ	['いか', 'するめいか', 'するめイカ', 'ほたるいか', 'ほたるイカ', 'やりいか', 'やりイカ', 'スルメいか', 'スルメイカ', 'ホタルいか', 'ホタルイカ', 'ヤリいか', 'ヤリイカ', '槍烏賊', '烏賊', '蛍烏賊', '鯣烏賊']
イカナゴ	['いかなご', 'フルセ', '玉筋魚', '鮊子']
イチゴ	['いちご', '苺']
イワシ	['いわし', 'オイルサーディン', 'オイルサーディーン', 'カタクチイワシ', '小鰯', '真いわし', '鰯']
インゲン豆	['いんげんまめ', 'いんげん豆', 'インゲンマメ', '大福豆', '白いんげん豆', '白インゲン豆']
イースト	['ドライイースト', '天然酵母', '酵母']
ウインナー	['ウィンナソーセージ', 'ウィンナー', 'ウィンナーソーセージ', 'ウインナ', 'ウインナーソーセージ', 'シャウエッセン', 'ジョンソンヴィル', 'ソーセジ', 'ソーセージ', 'ソーゼージ', 'チョリソ', 'チョリソー', 'ボロニアソーセージ', 'ボローニャソーセージ', 'ポークウィンナー', 'ポークソーセージ', 'ポークビッツ', 'モルタデッラ', 'ヴァイスブルスト']
ウスターソース	['おこのみソース', 'おこのみ焼きソース', 'おこのみ焼き用ソース', 'おたふくソース', 'お好みやきソース', 'お好みやき用ソース', 'お好みソース', 'お好み焼きソース', 'お好み焼き用ソース', 'お好み焼ソース', 'お好み焼用ソース', 'こいくちソース', 'たこやきソース', 'たこ焼きソース', 'たこ焼ソース', 'とんかつソース', 'どろソース', 'やきそばソース', 'ウスターシャソース', 'ウースターソース', 'タコヤキソース', 'タコ焼きソース', 'タコ焼ソース', 'トンカツソース', 'ヤキソバソース', '中濃ソース', '中農ソース', '御好みソース', '御好み焼きソース', '御好み焼き用ソース', '御好み焼ソース', '御好み焼用ソース', '濃厚ソース', '焼きそばソース', '焼きソバソース', '焼き蕎麦ソース', '焼そばソース', '蛸焼きソース', '蛸焼ソース']
ウド	['うど', '山ウド', '独活']
ウナギ	['うなぎ', '鰻']
ウニ	['うに', '雲丹']
エビ	['えび', 'さくらえび', 'アルゼンチンえび', 'アルゼンチンエビ', 'アルゼンチン海老', 'サクラエビ', 'バナメイエビ', 'ブラックタイガー', '伊勢えび', '伊勢エビ', '伊勢海老', '大正えび', '大正エビ', '大正海老', '小えび', '小エビ', '小海老', '有頭えび', '有頭エビ', '有頭海老', '桜えび', '桜エビ', '桜海老', '海老', '甘えび', '甘エビ', '甘海老', '車えび', '車エビ', '車海老']
エリンギ	['えりんぎ']
オイスターソース	['オイスタ−ソ−ス', '牡蠣油']
オクラ	['おくら', '赤オクラ']
オムレツ	['オムレツ〜', 'オムレツー']
オレガノ	['おれがの']
オーブン焼き	['オーブン焼き']
カキ	['かき', '牡蛎', '牡蠣']
カステラ	['かすていら', 'かすてら', 'かすてーら', 'カステイラ', 'カステーラ']
カボチャ	['かぼちゃ', '南瓜', '坊ちゃんかぼちゃ']
カラメル	['カラメルシロップ', 'カラメルソース', 'キャラメルシロップ', 'キャラメルソース']
カリフラワー	['ブロッコリ', 'ブロッコリー', 'ブローッコリー', 'ロマネスコ']
カレイ	['かれい', 'カラスカレイ', 'カラスガレイ', '鰈']
カレイの煮付け	['カレイの煮つけ', '鰈の煮つけ', '鰈の煮付け']
カレーうどん	['カレーうどん〜', 'カレー饂飩']
カレー粉	['カレースパイス', 'カレーパウダー', 'カレールゥー', 'カレールウ', 'カレールー']
ガーリック	['にんにく', 'ニンニク', 'プチニンニク', '大蒜', '葫', '蒜', '行者にんにく', '行者ニンニク']
キウイ	['キウィ', 'キウィフルーツ', 'キウイフルーツ', 'キュウイ', 'キーウィ', 'キーウィフルーツ', 'キーウィーフルーツ', 'キーウイ', 'ゴールドキウイ']
キムチ	['白菜キムチ']
キャベツ	['きゃべつ', '新キャベツ', '春きゃべつ', '春キャベツ', '紫キャベツ', '芽キャベツ']
キュウリ	['きゅうり', 'キューリ', '胡瓜']
クッキー	['クッキー〜', 'クッキーー']
クラゲ	['くらげ', '水月', '水母', '海月']
クリ	['くり', 'まろん', 'シバグリ', 'マロン', 'ヤマグリ', '山栗', '日本栗', '柴栗', '栗']
クリームシチューの素	['クリームシチューのもと', 'クリームシチューのルウ', 'クリームシチューのルー', 'クリームシチュールウ']
クリームスパゲティ	['クリームスパゲッティ', 'クリームスパゲッティー', 'クリームスパゲティー']
グレープフルーツ	['グレープフルーツルビー', 'ピンクグレープフルーツ']
ケチャップ	['けちゃっぷ', 'とまとけちゃっぷ', 'ケチップ', 'ケッチャップ', 'ケッチャプ', 'トマトケチップ', 'トマトケチャップ', 'トマトケッチャップ', 'トマトケッチャプ']
ケーキ	['ケーキ〜', 'ケーキー']
ココア	['カカオパウダー', 'ミロ']
コショウ	['こしょう', 'こしょー', 'グリーンペッパー', 'グリーンペパー', 'コショー', 'ブラックペッパー', 'ブラックペパー', 'ペッパー', 'ホワイトペッパー', 'ホワイトペパー', '白こしょう', '白こしょー', '白コショウ', '白コショー', '白胡椒', '胡椒', '赤こしょう', '赤こしょー', '赤コショウ', '赤コショー', '赤胡椒', '青こしょう', '青こしょー', '青コショウ', '青コショー', '青胡椒', '黒こしょう', '黒こしょー', '黒コショウ', '黒コショー', '黒胡椒']
コノシロ	['このしろ', '鮗', '鯯', '鰶', '鱅']
コーヒー豆	['エスプレッソ', 'カフェオレ', 'カフェラテ', 'キリマンジャロ', 'グアテマラ', 'コスタリカ', 'コナ', 'コーヒ', 'コーヒー', 'ブルーマウンテン', 'モカ', '珈琲']
ゴボウ	['ごぼう', '新ごぼう', '新ゴボウ', '新牛蒡', '牛蒡']
ゴーヤ	['ゴヤー', 'ゴーヤー', 'ゴー矢', 'ツルレイシ', 'ニガウリ', '白ゴーヤ', '白ゴーヤー']
ゴーヤチャンプルー	['ゴーヤチャンプル', 'ゴーヤチャンプルー']
サクランボ	['おうとう', 'さくらんぼ', 'アメリカンチェリー', 'ダークチェリー', 'チェリー', 'ドレンチェリー', 'ドレンドチェリー', '桜桃']
サケ	['さけ', 'さけフレーク', 'しゃけ', 'しゃけフレーク', 'キングサーモン', 'サケフレーク', 'サーモン', 'シャケ', 'シャケフレーク', '秋鮭', '紅鮭', '鮭', '鮭フレーク']
サザエ	['さざえ']
サトウキビ	['さとうきび', '砂糖きび', '砂糖黍']
サバ	['さば', '鯖']
サメ	['さめ', 'もうかさめ', 'もうかサメ', 'ホシザメ', 'モウカ鮫', 'モロサメ', '棒さめ', '鮫']
サラダ	['サラダ〜', 'サラダー']
サラダうどん	['サラダうどん〜', 'サラダうどーん']
サルサソース	['サルサ']
ザクロ	['ざくろ', '柘榴', '石榴', '若榴']
シソ	['おおば', 'しそ', 'オオバ', '大葉', '梅しそ', '紫蘇', '赤しそ', '青しそ', '青じそ', '青シソ', '青ジソ', '青紫蘇']
シナモン	['しなもん', 'にっき', 'ニッキ']
シフォンケーキ	['シフォンケーキ〜', 'シフォンケーキー']
シュウマイ	['しゅうまい', 'しゅーまい', 'シューマイ', '焼売']
シリアル	['オートミール', 'オールブラン', 'グラノーラ', 'コーンフレーク', 'コーンフレークス', 'シスコーンチョコリング', 'チョコパフィ', 'チーズグラノーラ', 'フルグラ', 'フルーツグラノーラ', '大豆グラノーラ', '玄米フレーク']
ジャガイモ	['じゃがいも', 'じゃが芋', 'ポテト', 'メークイン', 'メークイーン', '新じゃが', '新じゃがいも', '新ジャガ', '新ジャガイモ', '馬鈴薯']
ジャム	['あんずジャム', 'いちごジャム', 'りんごジャム', 'アップルジャム', 'アプリコットジャム', 'イチゴジャム', 'パンプキンジャム', 'ブルベリージャム', 'ブルーベリージャム', 'ママレードジャム', 'マンゴージャム', 'マーマレードジャム', 'ラズベリージャム', 'リンゴジャム', '林檎ジャム', '柿ジャム', '苺ジャム', '金柑ジャム']
スイカ	['すいか', '西瓜']
スナップえんどう	['スナックえんどう', 'スナックエンドウ', 'スナップエンドウ']
スパゲッティ	['スパ', 'スパゲッティ']
スプラウト	['かいわれ', 'かいわれ大根', 'かいわれ菜', 'カイワレ', 'カイワレ大根', 'カイワレ菜', 'ブロッコリースプラウト', '貝われ', '貝われ大根', '貝われ菜', '貝割れ', '貝割れ大根', '貝割れ菜', '貝割菜']
スープカレー	['スープカレー〜', 'スープーカレー']
ズッキーニ	['ズッキーニー', '花ズッキーニ']
ゼラチン	['セラチン', 'ゼライス', 'ゼリス']
タイ	['くろだい', 'たい', 'ちぬ', 'まだい', 'クロダイ', 'チヌ', 'マダイ', '真鯛', '茅渟', '鯛', '黒鯛']
タケノコ	['たけのこ', '竹の子', '筍']
タコ	['たこ', '蛸']
タチウオ	['たちうお', 'サワベル', 'シラガ', 'タチノウオ', 'ハクウオ', 'ハクナギ', '太刀魚', '立魚']
タレ	['たれ', 'だれ', 'つけだれ', 'つけダレ', 'ダレ', '付けだれ', '付けダレ', '垂れ', '漬けだれ', '漬けダレ']
チャンプルー	['チャンプル']
チョコレート	['ちょこ', 'イチゴチョコ', 'イチゴチョコレート', 'チョコ', 'チョコチップ', 'チョコペン', 'チョコレートチップ', 'チョコレートペン', 'ホワイトチョコ', 'ホワイトチョコレート', 'ミルクチョコ', 'ミルクチョコレート']
チョコレートケーキ	['チョコケーキ']
チンゲン菜	['ちんげんさい', 'ちんげん菜', 'チンゲンサイ', '青梗菜']
チーズ	['エメンタールチーズ', 'カチョカバロ', 'カッテージチーズ', 'カマンベルチーズ', 'カマンベール', 'カマンベールチーズ', 'クリームチーズ', 'クリームリーズ', 'グリュイエールチーズ', 'ゴルゴンゾーラ', 'シュレットチーズ', 'シュレッドチーズ', 'シュレトチーズ', 'スモークチーズ', 'スライスチーズ', 'チェダーチーズ', 'ナチュラルチーズ', 'パルメザン', 'パルメザンチーズ', 'ピザチーズ', 'フェタチーズ', 'ブリーチーズ', 'ブルーチーズ', 'プロセスチーズ', 'ベビーチーズ', 'ペコリーノ', 'マスカルポーネ', 'マスカルポーネチーズ', 'ミックスチーズ', 'モッツァレラ', 'モッツァレラチチーズ', 'モッツァレラチーズ', 'モッツアレラチーズ', 'モツァレラチーズ', 'モツアレラチーズ', 'リコッタチーズ', '粉チーす', '粉チーズ']
ツルムラサキ	['つるむらさき', '蔓紫']
トウモロコシ	['とうもろこし', 'コーン', 'スイートコーン', 'ヤングコーン']
トビウオ	['とびうお', '飛び魚', '飛魚']
トマト	['とまと', 'ぷちトマト', 'チェリートマト', 'フルーツトマト', 'プチトマト', 'ミディトマト', 'ミニトマト']
トマトサラダ	['トマトのサラダ']
トンカツ	['とんカツ', '豚カツ', '豚カツー']
トースト	['トースト〜', 'トーストー']
ドーナッツ	['ドーナツ']
ナスビ	['なす', 'なすび', 'ナス', '水ナス', '水茄子', '白茄子', '米なす', '米ナス', '米茄子', '茄子', '長なす', '長ナス', '長茄子', '青ナス']
ナツメグ	['なつめぐ', 'ニクズク', '肉荳蔲']
ナマズ	['なまず', 'キャットフィッシュ', '鯰']
ニシン	['にしん', '鯡', '鰊']
ニラ	['にら', '花ニラ', '韭', '韮']
ニンジン	['にんじん', 'キャロット', '人参', '金時人参']
ネギ	['あさつき', 'ねぎ', 'アサツキ', 'シラガねぎ', 'シラガネギ', 'シラガ葱', 'ワケギ', '万能ねぎ', '万能ネギ', '万能葱', '小ねぎ', '小ネギ', '小口ねぎ', '小口ネギ', '小口葱', '小葱', '浅葱', '白ねぎ', '白ネギ', '白葱', '白髪ねぎ', '白髪ネギ', '白髪葱', '細ねぎ', '細ネギ', '細葱', '葱', '薬味ねぎ', '薬味ネギ', '薬味葱', '長ねぎ', '長ネギ', '長葱', '青ねぎ', '青ネギ', '青葱']
ハゼ	['はぜ', '沙魚', '蝦虎魚', '鯊']
ハタハタ	['はたはた', '鰰']
ハム	['SPAM', 'コンビーフ', 'スパム', 'スパムミート', 'ソーセージミート', 'チャーシュー', 'パンチェッタ', 'ベーコン', 'ランチョンミート', '焼き豚', '焼豚', '生ハ', '鶏ハム', 'ＳＰＡＭ']
ハモ	['はも', '鱧']
ハンバーガー	['バーガー']
ハンバーグ	['ハンバーグ〜', 'ハンバーグー']
バナナ	['ばなな']
バニラ	['バニラエキストラクト', 'バニラエクストラクト', 'バニラエッセンス', 'バニラオイル', 'バニラビーンズ', 'バニラーエッセンス', 'バニラ油']
パイナップル	['パイン']
パウンドケーキ	['パウンドケーキ〜', 'パウンドケーキー']
パスタ麺	['アノリーニ', 'エリーケ', 'オレッキエッテ', 'カサレッチェ', 'カソンセイ', 'カッペリーニ', 'カペッリーニ', 'カルツォニッキ', 'カンネッローニ', 'ガッセ', 'ガルガネッリ', 'キタッラ', 'クスクス', 'クリンジョネス', 'コンキリエ', 'サラスパ', 'サラダスパゲッティ', 'サラダスパゲティ', 'サラダスパゲティー', 'サラダマカロニ', 'シェルマカロニ', 'シュペッツレ', 'ショートパスタ', 'ステッリーネ', 'ストロンカテッリ', 'スバゲティ', 'スパケテイ', 'スパゲtィ', 'スパゲッチィ', 'スパゲッティ', 'スパゲッティー', 'スパゲッティーニ', 'スパゲッティーニィ', 'スパゲッディ', 'スパゲティ-', 'スパゲティー', 'スパゲティーニ', 'スパゲテイ', 'スパゲテッィ', 'スパッゲティ', 'スパディー', 'スパベティー', 'スパ手ティー', 'タリアッテレ', 'タリアテッラ', 'タリアテッレ', 'タリオリーニ', 'チャルツォンス', 'ツィーテ', 'ディチェコ', 'トルテッリ', 'トルテッリーニ', 'トレネッテ', 'ニョッキ', 'バスタ', 'パスタ', 'パスタ・ミスタ', 'パッサテッリ', 'パッパルデッレ', 'パンツェロッティ', 'ビーゴリ', 'ピッツォッケリ', 'ファルファッレ', 'ファルファーレ', 'フィットチーネ', 'フェットチーネ', 'フェデリーニ', 'フェトチーネ', 'フジッリ', 'フスィリ', 'ブカティーニ', 'ベンネ', 'ペンネ', 'ペンネマカロニ', 'ペンネリガーテ', 'マカロニ', 'マッケローネ', 'マルタリアーティ', 'ライスマカロニ', 'ラザーニェ', 'ラザーニャ', 'ラビオリ', 'リガトーニ', 'リゾーニ', 'リングイネ', 'リングイーネ', 'ルオーテ', 'レジネッテ', 'ロティーニ', 'ヴェルミチェッリ']
パセリ	['バジリコ', 'バジル', 'メボウキ']
パパイヤ	['ぱぱいや']
パフェ	['パフェ〜', 'パフェー']
パン	['しょくパン', 'イングリッシュマフィン', 'クロワッサン', 'コッペパン', 'スティックパン', 'トルティーヤ', 'ナン', 'バケット', 'バゲット', 'バゲッド', 'バタール', 'バターロール', 'バンズ', 'バーンズ', 'パンズ', 'ピタパン', 'フランスパン', 'ブレッド', 'ベーグル', 'マフィン', 'ラスク', 'ロールパン', '食パン']
パン粉	['生パン粉']
ヒラメ	['ひらめ', '孫兵衛ひらめ', '平目', '沖ひらめ', '舌ヒラメ', '舌平目', '赤舌ひらめ']
ビワ	['びわ', '枇杷']
ピザ	['ピザ〜', 'ピザー']
ピーマン	['カラーピーマン', 'スウィーピー', 'バナナピーマン', 'パブリカ', 'パプリカ', '赤パプリカ', '赤ピーマン', '黄パプリカ', '黄ピーマン']
ピーマンの肉詰め	['肉詰め']
フグ	['かなとふぐ', 'ごまふぐ', 'しょうさいふぐ', 'ふぐ', 'カナトフグ', 'サバフグ', 'ショウサイフグ', 'シロサバフグ', '河豚', '鯖ふぐ']
フナ	['ふな', '鮒']
ブイヨン	['コンソメ', 'ブイオン', 'ブロス', 'ブロード', '洋風だし', '洋風ダシ', '洋風出汁', '野菜だし', '野菜ダシ', '野菜出汁']
ブリ	['はまち', 'ぶり', 'ハマチ', 'ワラサ', '寒ぶり', '寒ブリ', '寒鰤', '鰤']
ブリの照り焼き	['ぶりの照り焼き', 'ブリのてりやき', 'ブリの照焼き', '鰤...', '鰤のてりやき', '鰤の照り焼き']
ブルーベリー	['ワイルドベリー']
プリン	['ぷりん', 'プディング', 'プリン']
ホイル焼き	['ホイル焼き']
ホットケーキミックス	['HCM', 'HM', 'ケーキミックス', 'パンケーキミックス', 'ホッツトケーキ粉', 'ホットクミックス', 'ホットケキミックス', 'ホットケーキMIX', 'ホットケーキミクス', 'ホットケーキ粉', 'ホットケーキＭＩＸ', 'ＨＣＭ', 'ＨＭ']
ホヤ	['ほや', 'ほや貝', 'ホヤ貝']
ボラ	['ぼら', '沖ボラ', '鮱', '鯔', '鰡']
ポテトサラダ	['ポテサラ']
ポン酢	['あじぽん', 'あじポン', 'ぽんず', 'ぽんずしょうゆ', 'ぽんず醤油', 'ぽん酢', 'ぽん酢しょうゆ', 'ぽん酢醤油', 'ポンズ', 'ポンズしょうゆ', 'ポンズ醤油', 'ポン酢しょうゆ', 'ポン酢醤油', '味ぽん', '味ポン']
マグロ	['きはだ', 'きはだまぐろ', 'くろまぐろ', 'びんちょう', 'びんちょうまぐろ', 'びんなが', 'びんながまぐろ', 'びん長', 'まぐろ', 'めばち', 'めばちまぐろ', 'イトシビ', 'カンタ', 'カンタロウ', 'キハダ', 'キハダまぐろ', 'キハダマグロ', 'キハダ鮪', 'キワダ', 'キンヒレ', 'クロシビ', 'クロマグロ', 'クロ鮪', 'ゲスナガ', 'シビ', 'シビマグロ', 'ツナ', 'トンボ', 'トンボシビ', 'トンボマグロ', 'ハツ', 'バチ', 'ビナガ', 'ビンチョウ', 'ビンチョウマグロ', 'ビンナガ', 'ビンナガマグロ', 'ビン長', 'ホンマグロ', 'マシビ', 'メバチ', 'メバチマグロ', 'メブト', '中とろ', '中トロ', '大とろ', '大トロ', '木肌', '木肌鮪', '目鉢', '目鉢マグロ', '目鉢鮪', '鮪', '黄肌', '黄肌まぐろ', '黄肌マグロ', '黄肌鮪', '黒鮪']
マシュマロ	['マシマロ', 'マショマロ']
マスタード	['つぶマスタード', 'イエローマスタード', 'ディジョンマスタード', 'ハニーマスタード', 'マスタート', '洋がらし', '粒マスタード']
マッシュルーム	['ブラウンマッシュルーム', 'ホワイトマッシュルーム', 'マシュルーム', 'マッシルーム']
マツカサウオ	['まつかさうお', '松笠魚']
マヨネーズ	['マヨ', 'マヨーネーズ']
マンゴー	['あんまら', 'あんら', 'アンマラ', 'アンラ', 'フィリピンマンゴー', 'マンゴ', '檬果', '芒果', '菴摩羅', '菴羅']
マーボー豆腐	['マーボーとうふ', 'マーボーどうふ']
ミカン	['いよかん', 'みかん', 'オレンジ', 'ネーブル', 'ネーブルオレンジ', 'ポンカン', '伊予柑', '夏みかん', '夏ミカン', '文旦', '蜜柑']
ミックスビーンズ	['お豆ミックス']
ミックスベジタブル	['ベジタブルミックス', 'ベジミックス', 'ミックスベジ', 'ミックスベジタベル', '野菜ミックス']
ミツバ	['みつば', 'みつ葉', '三つ葉', '三ツ葉', '三葉']
ムギ	['こぞくさ', 'むぎ', 'エンバク', 'オオムギ', 'カワムギ', 'コムギ', 'ハダカムギ', 'ビールムギ', 'ライムギ', '二条オオムギ', '二条大麦', '六条オオムギ', '去年草', '四条オオムギ', '大麦', '小麦', '引き割り麦', '押し麦', '裸オオムギ', '裸麦', '麦']
ムール貝	['しゅうり貝']
メジナ	['ぐれ', 'めじな', 'グレ', '眼仁奈']
メロン	['アンデスメロン', 'ジャコウウリ', 'ハニーデューメロン', 'ハネデューメロン', 'ハネージュメロン', 'マスクメロン', '夕張メロン']
モロヘイヤ	['もろへいや', 'モロヘイア']
ヤマメ	['やまめ', '山女', '山女魚']
ユリ根	['ゆりね', 'ゆり根', '百合の根', '百合根']
ヨモギ	['よもぎ', '蓬']
ヨーグルト	['カスピ海ヨーグルト', 'プレーンヨーグルト']
ライス	['ライス〜', 'ライスー']
ラタトゥイユ	['ラタトゥイユ〜', 'ラタトゥユ']
ラディッシュ	['ハツカダイコン', '二十日大根', '廿日大根']
ラム酒	['ゴールドラム', 'ダークラム', 'ヘビーラム', 'ホワイトラム', 'ミディアムラム', 'ライトラム']
ラー油	['辣油']
リンゴ	['りんご', '林檎']
レタス	['エンダイブ', 'グリーンカール', 'グリーンリーフ', 'グリーンレタス', 'サニーレタス', 'サンチェ', 'サンチュ', 'フリルレタス', 'プリーツレタス', 'ボストンレタス', 'リーフレタス', 'ロメインレタス']
レモン	['れもん', '檸檬', '青レモン']
レモン汁	['れもんの汁', 'れもん果汁', 'れもん汁', 'ポッカれもん', 'ポッカレモン', 'ポッカ檸檬', 'レモンの汁', 'レモン果汁', '檸檬の汁', '檸檬果汁', '檸檬汁', '濃縮れもん', '濃縮レモン', '濃縮檸檬']
レンジ蒸し	['レンジ蒸し']
レンズ豆	['レンズマメ', '赤レンズ豆']
レーズン	['ラムレーズン', '干しぶどう', '干しブドウ', '干し葡萄', '干葡萄']
ローリエ	['ゲッケイジュ', 'ベイリーフ', 'ベイリーブズ', 'ロリエ', 'ロールベールブレッター', 'ローレル', '月桂樹']
ワイン	['ロゼワイン', '白ワイン', '赤ワイン']
ワカサギ	['わかさぎ', '公魚']
ワカメ	['わかめ', '若布', '茎わかめ', '茎ワカメ']
ワサビ	['わさび', 'セイヨウワサビ', 'ホースラディッシュ', '山葵', '本わさび', '本ワサビ', '本山葵', '練りわさび', '練りワサビ', '練り山葵', '西洋わさび', '西洋ワサビ', '西洋山葵']
中華麺	['ちゃんぽん麺', 'やきそば', 'らーめん', 'チャンポン麺', 'マルちゃん正麺', 'ヤキソバ', 'ラーマン', 'ラーメン', '中華そば', '中華めん', '中華乾麺', '中華蒸し麺', '拉麺', '焼きそば', '焼きソバ', '豆腐麺']
丼	['どんぶり', 'どんぶり〜', 'どんぶりぃ', 'どーんぶり']
人参のきんぴら	['...', 'にんじんのきんぴら', 'にんじんのキンピラ', 'ニンジンのきんぴら', '人参のキンピラ']
伊達巻	['だてまき', 'だて巻', 'だて巻き', '伊達まき', '伊達巻き']
佃煮	['つくだに', 'つくだ煮']
八角	['スターアニス', '八角茴香', '大茴香']
冷やしうどん	['ひやしうどん', '冷しうどん']
冷奴	['ひややっこ', '冷ややっこ', '冷や奴', '冷奴']
冷麺	['れーめん', '冷めん']
切り干し大根の煮物	['きりぼし大根の煮物', '切り干し大根の煮もの', '切干し大根の煮もの', '切干し大根の煮物']
刺身	['さしみ', '刺し身']
包む	['包み']
包んで焼く	['包みやき', '包み焼き', '包み焼き〜']
卵	['うずら', 'うずらの卵', 'うずら卵', 'たまご', 'ウズラ卵', 'タマゴ', '全卵', '卵白', '卵黄', '玉子', '白身', '鶏卵', '黄身']
卵かけご飯	['卵かけゴハン', '卵かけ御飯']
卵とじ	['卵とじ〜', '卵閉じ']
卵焼き	['たまごやき', 'たまご焼', 'たまご焼き', '卵やき', '卵焼', '卵焼き〜']
厚揚げの煮物	['厚あげの煮物', '厚揚げの煮もの']
吸い物	['お吸いもの', 'お吸い物', 'お吸物', '吸いもの', '吸物', '御吸物']
味の素	['うまみ調味料', 'うま味調味料', 'こぶうま', 'ハイミー', '旨み調味料', '旨味調味料']
味噌	['XO醤', 'なりみす', 'なりみそ', 'なり味噌', 'みそ', 'コチジャン', 'コチュジャン', 'ティェメンジャン', 'テンメンジャン', 'トウチジャン', 'トウバンジャン', 'ドウバンジャン', '中華甘みそ', '中華甘味噌', '八丁みそ', '八丁味噌', '南蛮みそ', '南蛮味噌', '唐辛子みそ', '唐辛子味噌', '甜麺醤', '白みそ', '白味噌', '米みそ', '米味噌', '蘇鉄みそ', '蘇鉄味噌', '西京みそ', '西京味噌', '調合みそ', '調合味噌', '豆みそ', '豆味噌', '豆板醤', '豆瓣醤', '赤みそ', '赤味噌', '金山寺みそ', '金山寺味噌', '麦みそ', '麦味噌', '麺醤']
味噌汁	['おみそしる', 'おみそ汁', 'お味噌汁', 'みそしる', 'みそ汁']
和える	['ぁ', 'ぁぇ', 'あぇ', 'あえ', 'あえ〜', '合う', '合え〜', '和ぇ', '和え', '和え〜', '和える', '和えー']
唐揚げ	['からぁげ', 'からあげ', 'からあげ〜', 'から揚', 'から揚げ', 'から揚げ〜', '空揚げ']
唐辛子	['ししとう', 'ししとうがらし', 'しし唐', 'しし唐辛子', 'とうがらし', 'ひもとうがらし', 'ひも唐辛子', 'シシトウガラシ', 'ジャンボししとう', 'トウガラシ', '万願寺とうがらし', '万願寺トウガラシ', '万願寺唐辛子', '伏見とうがらし', '唐芥子', '満願寺唐辛子', '獅子唐辛子', '甘とうがらし', '甘唐辛子', '甘長とうがらし', '甘長唐辛子', '葉唐辛子', '蕃椒', '赤唐辛子', '青とうがらし', '青唐辛子', '韓国唐辛子']
塩焼きそば	['塩やきそば', '塩焼き蕎麦']
塩麹	['しおこうじ', '塩こうじ']
大学芋	['大学いも', '大学いもー', '大学イモ']
大根	['たくあん', 'だいこん', 'だいこんおろし', 'タクアン', 'ダイコン', 'ダイコンおろし', '切り干しだいこん', '切り干しダイコン', '切り干し大根', '切干しだいこん', '切干しダイコン', '切干し大根', '切干だいこん', '切干ダイコン', '切干大根', '大根おろし', '干しだいこん', '干しダイコン', '干し大根', '春だいこん', '春ダイコン', '春大根', '紫だいこん', '紫ダイコン', '紫大根', '聖護院だいこん', '聖護院ダイコン', '聖護院大根', '赤だいこん', '赤ダイコン', '赤大根']
大根の煮物	['だいこんの煮物', 'ダイコンの煮物', '大根の煮もの']
大根サラダ	['だいこんのサラダ', 'ダイコンのサラダ', '大根のサラダ']
大豆	['だいず', 'ソイミート', 'ダイズ', '大豆パウダー', '大豆ミート', '大豆粉', '大豆肉', '青大豆', '黒千石大豆']
天ぷら	['てんぷら', '天ぷら〜', '天婦羅']
寿司	['すし', 'スシ', '鮨']
小松菜	['うぐいすな', 'こまつな', 'ふゆな', 'もちな', 'ウグイスナ', 'コマツナ', 'フユナ', 'モチナ', '冬菜', '餅菜', '鶯菜']
小豆	['あずき', 'アズキ']
小麦粉	['お好み焼き子', 'お好み焼き粉', 'お好み焼粉', 'からあげ粉', 'から揚げ粉', 'たこ焼き粉', 'たこ焼粉', 'てんぷら粉', 'はくりきこ', 'はったい粉', 'ふすま粉', 'イーグル', 'キタノカオリ', 'グラハム粉', 'セモリナ粉', 'チヂミ粉', 'ヒラヤーチ粉', 'ライ麦粉', 'リスドォル', '中力粉', '全粒粉', '唐揚げ粉', '唐揚粉', '天ぷら粉', '小麦', '小麦後', '強力粉', '浮き粉', '薄力粉', '麦こがし']
山椒	['さんしょう', 'サンショウ', 'ハジカミ']
山芋	['とろろ芋', 'ながいも', 'やまいも', 'やまと芋', 'ナガイモ', 'ヤマイモ', '大和芋', '長いも', '長イモ', '長芋']
巻く	['巻き', '巻き〜', '巻きー']
帆立貝	['ほたて', 'ほたて貝', 'ホタテ', 'ホタテガイ', 'ホタテ貝', '帆立']
抹茶	['お抹茶', 'まっちゃ', 'りょくちゃ', 'グリーンティ', 'グリーンティー', '緑茶']
押し寿司	['押し鮨', '押寿司', '押鮨']
挽肉	['あいびきミンチ', 'あいびき肉', 'あい挽き肉', 'ひいき肉', 'ひきにく', 'ひき肉', 'ミンチ', 'ミンチ肉', '合いびき肉', '合い挽き', '合い挽きミンチ', '合い挽き肉', '合びき', '合びきミンチ', '合びき肉', '合ミンチ', '合挽', '合挽き', '合挽きミンチ', '合挽き肉', '合挽ミンチ', '合挽肉', '挽き肉', '牛ひき肉', '牛ミンチ', '牛合挽肉', '牛挽き肉', '牛挽肉', '牛肉ミンチ', '牛豚合い挽き肉', '牛豚合挽肉', '豚ひき肉', '豚びき', '豚ミンチ', '豚ミンチ肉', '豚引き肉', '豚挽き肉', '豚挽肉', '鳥ひき肉', '鳥ミンチ肉', '鶏ひき', '鶏ひき肉', '鶏ミンチ', '鶏ミンチ肉', '鶏挽き肉', '鶏挽肉']
揚げて浸す	['あげひたし', 'あげびたし', 'あげ浸し', '揚げひたし', '揚げびたし', '揚げ浸し']
揚げて煮る	['揚げ煮']
揚げる	['あげ', 'あげ〜', '揚げ', '揚げ〜']
揚げ出し豆腐	['あげ出し豆腐', '揚げ出しどうふ']
揚げ餃子	['あげぎょうざ', 'あげ餃子', '揚げぎょうざ', '揚げギョウザ', '揚げギョーザ']
昆布	['おぼろこんぶ', 'おぼろコンブ', 'おぼろ昆布', 'こんぶ', 'だしこんぶ', 'だしコンブ', 'だし昆布', 'コンブ', 'ダシこんぶ', 'ダシコンブ', 'ダシ昆布', '出汁こんぶ', '出汁コンブ', '出汁昆布', '塩こんぶ', '塩コンブ', '塩昆布', '根こんぶ', '根コンブ', '根昆布']
春巻	['はる巻き', '春巻き', '春巻き〜']
春菊	['おたふく', 'きくな', 'しゅんぎく', 'ちゅうば', 'ろーま', 'シュンギク', '中葉', '菊菜']
春雨	['はるさめ', 'チャプチェ麺', '緑豆はるさめ', '緑豆春雨', '韓国はるさめ', '韓国春雨']
春雨サラダ	['はるさめサラダ', '春雨サラダ〜']
枝豆	['えだまめ', 'エダマメ', '紫ずきん', '茶豆']
柿	['かき', 'カキ']
桃	['もも', 'ピーチ', 'モモ', '白桃', '黄桃']
梅	['うめぼし', 'ウメボシ', '南高梅', '梅ぼし', '梅干', '梅干し', '青梅']
梨	['なし', 'ナシ']
椎茸	['しいたけ', 'シイタケ']
水	['ぉ湯', 'お湯', 'みず', 'ウォーター', '水', '湯', '飲料水']
水ようかん	['みずようかん', '水羊羹']
水菜	['みずな', 'みず菜', 'サラダ水菜', 'ミズナ']
水餃子	['水ぎょうざ', '水ギョウザ', '水ギョーザ']
氷砂糖	['氷糖']
油	['EVオリーブオイル', 'EVオリーブ油', 'EXVオリーブオイル', 'EXオリーブオイル', 'あぶら', 'けし油', 'こめ油', 'ごま油', 'ざくろの種油', 'なたね油', 'にんにくオイル', 'ひまし油', 'ひまわり油', 'アケビ油', 'アケビ種子油', 'アブラ', 'アプリコット核油', 'アボカドオイル', 'アリーブオイル', 'アルガンオイル', 'アーモンドオイル', 'イルカ油', 'ウミクロウメモドキ種子油', 'ウールグリース', 'エキストラバージンオイル', 'エキストラバージンオリーブオイル', 'エクストラバージンオイル', 'エクストラバージンオリーブオイル', 'エッセンシャル・オイル', 'エビ油', 'エミューオイル', 'オイル', 'オリーブイル', 'オリーブオイリ', 'オリーブオイル', 'オリーブ油', 'オリープオイル', 'オリーヴオイル', 'オリーーブオイル', 'オーリブ油', 'カカオバター', 'カラシ油', 'カルナウバワックス', 'ガマの油', 'キウイフルーツシードオイル', 'キャスターオイル', 'キャノーラ油', 'キャンデリラワックス', 'ギー', 'ククイナッツオイル', 'クランベリーシードオイル', 'グレープシードオイル', 'コクムバター', 'コプラ油', 'コーヒー豆油', 'コーンオイル', 'コーン油', 'ゴマ油', 'サフラワー油', 'サラサ油', 'サラザ油', 'サラダア油', 'サラダオイル', 'サラダ油', 'サラ油', 'サルバター', 'シアバター', 'シュマルツ', 'シュートニング', 'ショートニング', 'シーバクソン', 'スクワラン', 'セサミオイル', 'チェリー核油', 'チンク油', 'ナンヨウアブラギリ油', 'ニーム油', 'バオバブオイル', 'バタ−', 'バター', 'ババスオイル', 'バージンオイル', 'バージンオリーブ油', 'バータ', 'バーター', 'パター', 'パンプキンシードオイル', 'パーム核油', 'パーム油', 'ピスタチオオイル', 'ピーナッツオイル', 'ファットスプレッド', 'フラックスシードオイル', 'ブロッコリーシードオイル', 'ヘット', 'ヘンプオイル', 'ヘーゼルナッツオイル', 'ベニバナ油', 'ペカンナッツオイル', 'ホホバオイル', 'ボリジオイル', 'ポピーシードオイル', 'マカダミアナッツオイル', 'マスタードオイル', 'マルゴーサ油', 'マルーラナッツオイル', 'マンゴバター', 'マーガリン', 'メドウフォーム油', 'メロンシードオイル', 'モモ核油', 'モンゴンゴオイル', 'ヤシ油', 'ヤトロファ油', 'ラノリン', 'ラード', 'リンシードオイル', 'ルリジサ種子油', 'ローズヒップオイル', 'ローレルオイル', '亜麻仁油', '卵黄油', '大豆油', '大風子油', '天ぷら油', '密陀油', '小麦胚芽油', '山茶花油', '巴豆油', '揚げ油', '揚油', '月桂樹実油', '月見草油', '木蝋', '杏仁油', '桐油', '植物油', '榧油', '油瀝青油', '烏臼油', '牛油', '牛脂', '牛脚油', '生姜油', '白樺油', '白油', '白絞油', '米油', '精油', '糠油', '紫蘇油', '綿実油', '肉荳蔲油', '肝油', '胡桃油', '胡麻油', '脂', '茶梅油', '茶油', '荏油', '菜種油', '葡萄油', '葱油', '蘇油', '蛹油', '蜜蝋', '蟹油', '酥油', '馬油', '骨油', '骨脂', '魚油', '鮫油', '鯨油', '鴨油', '鵞鳥油', '鶏油', '鶏脂', '麻実油']
油揚げ	['あげ', 'あぶらあげ', 'うすあげ', 'うす揚げ', 'お揚げ', '小揚げ', '揚げる', '油あげ', '油揚', '薄揚げ']
洋梨	['セイヨウナシ', 'ラフランス', 'ラ・フランス', '洋なし', '洋ナシ', '西洋梨']
海苔	['あおさのり', 'あおさ海苔', 'のり', 'アオサノリ', 'アオサ海苔', 'ノリ', '岩のり', '岩ノリ', '岩海苔', '青さのり', '青のり', '青のり粉', '青ノリ', '青ノリ粉', '青海苔', '青海苔粉', '韓国のり', '韓国ノリ', '韓国海苔']
海苔巻き	['のりまき', 'のり巻', 'のり巻き', '海苔まき', '海苔巻']
浸す	['ひたし', 'びたし', '浸し', '浸し〜']
混ぜご飯	['まぜご飯', 'まぜゴハン', 'まぜ御飯', '混ぜゴハン', '混ぜ御飯']
漬けて焼く	['浸け焼き', '漬け焼き', '漬焼き']
漬ける	['浸け', '漬', '漬け', '漬け〜', '漬けー']
漬け丼	['漬けどんぶり', '漬丼']
漬物	['つけもの', 'つけ物', '漬けもの', '漬け物', '漬もの']
澱粉	['でんぷん', 'コンスターチ', 'コーングリッツ', 'コーンスターチ', 'スターチ', 'デンプン']
炊き込みご飯	['炊き込みごはん', '炊き込みご飯']
炊く	['炊き']
炒めて煮る	['炒め煮', '炒り煮']
炒める	['いため', 'いため〜', '炒め', '痛め']
炭酸水	['たんさんすい', 'キリンレモン', 'コーラ', 'コーラー', 'サイダー', 'ジンジャーエール', 'スパークリングウォーター', 'スプライト', 'ソーダ', 'ソーダー', 'ソーダ水', 'ネックス', 'ペプシ', '炭酸', '炭酸飲料', '発砲水']
無花果	['いちじく', 'イチジク']
焼いて浸す	['やきびたし', '焼きひたし', '焼きびたし', '焼き浸し']
焼きうどん	['やきうどん', '焼うどん', '焼きうどーん', '焼き饂飩']
焼きおにぎり	['やきおにぎり', '焼きおにぎり〜', '焼きお握り', '焼きオニギリ']
焼きそば	['やきそば', 'やーきそば', '焼きそば〜', '焼き蕎麦']
焼きナス	['やきなす', '焼きなす', '焼き茄子']
焼き鳥	['やきとり', 'やき鳥', '焼鳥']
焼く	['やき', '焼', '焼き', '焼き〜', '焼きー']
照り焼きチキン	['てりやきチキン', '照焼きチキン']
照り煮	['照り煮']
煮て浸す	['煮ひたし', '煮びたし', '煮浸し', '煮浸し〜']
煮る	['煮']
煮物	['にもの', '煮もの']
煮込む	['煮混み', '煮込み', '煮込み〜']
片栗粉	['かたくり', 'かたくりこ', 'かたくり粉', 'カタクリ', 'カタクリコ', 'カタクリ粉', '片栗']
牛乳	['ぎゅうにゅう', 'ココナッツミルク', 'コーヒーフレッシュ', 'ミルク', '豆乳']
牛肉	['ビーフ', '和牛すじ肉', '牛', '牛かたまり肉', '牛こま切れ肉', '牛こま肉', '牛すじ', '牛すじ肉', '牛すね肉', '牛ばら肉', '牛ほほ肉', '牛もも', '牛もも肉', '牛カルビ', '牛カルビ肉', '牛コマ', '牛コマ切れ', '牛スジ', '牛スジ肉', '牛ステーキ肉', '牛スネ肉', '牛タン', '牛ハラミ', '牛バラ肉', '牛バラ薄切り肉', '牛ヒレ肉', '牛モモ', '牛モモブロック', '牛モモ塊肉', '牛モモ肉', '牛ロース肉', '牛切り落とし', '牛切り落とし肉', '牛味付け肉', '牛小間肉', '牛筋', '牛筋肉', '牛細切れ肉', '牛肉かたまり', '牛肉かたまり肉', '牛肉こまぎれ', '牛肉こま切れ', '牛肉もも肉', '牛肉スライス', '牛肉切り落とし', '牛肉薄切り', '牛肩バラ切り落とし', '牛肩ロース', '牛薄切り', '牛薄切り肉', '薄切り牛肉']
玉ねぎのサラダ	['たまねぎのサラダ', 'タマネギのサラダ', '玉葱のサラダ']
玉子とじ	['たまごとじ', 'タマゴとじ']
玉子焼き	['タマゴ焼き', 'タマゴ焼き〜', '玉子やき', '玉子焼き〜']
玉葱	['たまねぎ', 'オニオン', 'タマネギ', '新たまねぎ', '新タマネギ', '新玉ねぎ', '新玉ネギ', '新玉葱', '玉ねぎ', '玉ネギ', '紫たまねぎ', '紫玉ねぎ', '葉玉ねぎ', '赤玉ねぎ', '赤玉葱']
甘酒	['あまざけ', 'あま酒']
生チョコ	['なまチョコ', '生チョコ〜']
生姜	['しょうが', 'ショウガ', '土しょうが', '土ショウガ', '土生姜', '土生薑', '土薑', '新しょうが', '新ショウガ', '新生姜', '新生薑', '新薑', '生薑', '薑', '谷中しょうが', '谷中ショウガ', '谷中生姜', '谷中生薑', '谷中薑', '針しょうが', '針ショウガ', '針生姜', '針生薑', '針薑']
白菜	['はくさい', 'ハクサイ']
目玉焼き	['めだまやき', '目玉やき']
砂糖	['さとう', 'ざらめ', 'ざらめ糖', 'てんさい糖', 'てん菜糖', 'エリスリム', 'オリゴ糖', 'カソナード', 'キビ糖', 'グラニュー糖', 'ザラメ', 'ザラメ糖', 'シュガー', 'ショ糖', 'パウダーシュガー', 'パルスイート', 'パルスウィート', 'ブラウンシュガー', 'メープルシュガー', '三温糖', '上白糖', '中双糖', '和三盆', '甜菜糖', '白下糖', '白双糖', '粉砂糖', '粉糖', '粗糖', '素焚糖', '角砂糖', '赤砂糖', '転化糖', '黒砂糖', '黒糖']
秋刀魚	['さんま', 'サンマ']
米粉	['お米の粉', 'こめこ', 'だんご粉', 'みじん粉', 'もち粉', 'リ・ファリーヌ', '上南粉', '上新粉', '上用粉', '乳児穀粉', '乳児粉', '団子粉', '寒ざらし粉', '寒梅粉', '微塵粉', '求肥粉', '玄米粉', '白玉粉', '落雁粉', '道明寺粉', '餅粉']
米飯	['うるごめ', 'うるちまい', 'うるち米', 'うる米', 'おこめ', 'お米', 'こめ', 'ご飯', 'もちごめ', 'もちまい', 'もち米', 'ウルチ米', 'コメ', 'ゴハン', 'タイ米', 'モチ米', 'ライス', '五穀米', '御飯', '押し麦', '押麦', '玄米', '玄米ごはん', '玄米ご飯', '玄米ゴハン', '玄米御飯', '発芽玄米', '白ごはん', '白ご飯', '白ゴハン', '白御飯', '白米', '白飯', '米', '米粒', '粳米', '糯米', '雑穀ごはん', '雑穀ご飯', '雑穀ゴハン', '雑穀御飯', '雑穀米', '餅米', '麦ごはん', '麦ご飯', '麦ゴハン', '麦御飯', '黒米']
粉末ミルク	['こなミルク', 'ふんにゅう', 'クリープ', 'クリーミングパウダー', 'スキムミルク', 'ミルメーク', '粉ミルク', '粉乳', '脱脂粉乳']
紅生姜	['ガリ', '紅しょうが', '紅ショウガ']
紅茶	['TP', 'アイスティ', 'アイスティー', 'アッサム', 'アップルティ', 'アップルティー', 'アールグレイティー', 'アールグレー', 'ウバ', 'カモミールティ', 'カモミールティー', 'シレット', 'ジャワティー', 'ストレートティ', 'ストレートティー', 'ストロベリーティ', 'セイロンティー', 'タイティー', 'ダージリン', 'ダージリンティー', 'チャイ', 'チャイティー', 'ティーバック', 'ティーバッグ', 'ティーパック', 'ティーパッグ', 'ニルギリ', 'ネパール', 'ハイビスカスティー', 'ハーブティー', 'ピーチアプリコット', 'ミントティ', 'ミントティー', 'ルイボスティー', 'レモンティ', 'ローズヒップティー', 'ローゼルティー', '正山小種', '滇紅', '祁門']
納豆	['なっとう', 'ひきわり納豆', '黒豆納豆']
素揚げ	['素揚げ']
練乳	['れん乳', 'エバミルク', 'コンデンスミルク', '煉乳', '練りミルク']
肉じゃが	['にくじゃが', '肉じゃが〜']
肉まん	['にくまん', '肉ま〜ん', '肉饅']
肉味噌	['にくみそ', 'にく味噌', '肉みそ', '肉ミソ']
肉団子	['にくだんご', '肉だんご']
肉巻きおにぎり	['肉巻きお握り', '肉巻きオニギリ']
肉豆腐	['にく豆腐', '肉とうふ', '肉どうふ']
芥子	['からし', 'ねりからし', 'ねりがらし', 'カラシ', '和がらし', '練からし', '練がらし', '練りからし', '練りがらし', '練りカラシ', '練りガラシ', '練り芥子', '練り辛子', '練カラシ', '練ガラシ', '練芥子', '練辛子', '辛子']
花椒	['ホアジャオ', 'ホワジャオ']
茄子の揚げ浸し	['なすの揚げびたし', 'なすの揚げ浸し', 'ナスの揚げびたし', 'ナスの揚げ浸し', '茄子の揚...']
茄子の煮浸し	['なすの煮びたし', 'なすの煮浸し', 'ナスの煮びたし', 'ナスの煮浸し', '茄子の煮びたし']
茗荷	['みょうが', 'みょうがたけ', 'みょうが竹', 'ミョウガ', '花みょうが']
茶漬け	['茶漬け〜', '茶漬けー']
菜の花	['なばな', '菜花']
落花生	['くるみ', 'アーモンド', 'カシューナッツ', 'ナッツ', 'バターピー', 'ピーカンナッツ', 'ピーナッツ', 'ピーナツ', 'ヘーゼルナッツ', 'マカダミアナッツ', 'マカデミアナッツ', 'ミックスナッツ']
葡萄	['あづましずく', 'ぶどう', 'カルディナル', 'グレープ', 'コンコード', 'コールマン', 'シャスラ', 'デラウェア', 'ナガノパープル', 'ピオーネ', 'ブドウ', 'ブラックオリンピア', 'ブラック・コリンス', 'マスカット', 'レッドグローブ', '多摩ゆたか', '安芸クイーン', '巨峰', '甲斐路', '竜宝', '紅伊豆', '紅瑞宝', '紫玉', '藤稔', '高妻']
蒲焼	['かばやき', 'かば焼', 'かば焼き', '蒲焼き', '蒲焼き〜']
蒸して焼く	['むし焼き', '蒸焼き']
蒸して煮る	['蒸し煮']
蒸す	['蒸し', '蒸し〜', '蒸しぃ']
蜂蜜	['はちみつ', 'はつみつ', 'ガムシロップ', 'ケーキシロップ', 'ハチミツ', 'メイプルシロップ', 'メープルシロップ', '水あめ', '水飴', '黒みつ', '黒蜜']
親子丼	['おやこ丼', '親子どんぶり']
豆腐	['おとうふ', 'おぼろ豆腐', 'お豆腐', 'とうふ', 'もめん豆腐', 'トウフ', '充填豆腐', '冷奴', '厚揚げ', '厚揚げ豆腐', '寄せ豆腐', '木綿とうふ', '木綿豆腐', '絹こしとうふ', '絹こし豆腐', '絹ごし', '絹ごしとうふ', '絹ごし豆腐', '絹とうふ', '絹豆腐']
豆腐ステーキ	['とうふステーキ', 'とーふステーキ']
豚の角煮	['ぶたの角煮', 'ブタの角煮']
豚キムチ	['ぶたキムチ', '豚キムチ〜']
豚汁	['とんじる', 'とん汁']
豚肉	['ぶたバラ肉', 'ブタ肉', 'ポーク', '塩ブタ', '塩豚', '薄切り豚肉', '豚', '豚かた', '豚かたまり', '豚かたまり肉', '豚かたロース', '豚こま', '豚こまぎれ肉', '豚こま切れ', '豚こま切れ肉', '豚こま肉', '豚しゃぶしゃぶ肉', '豚そともも', '豚ばら', '豚ばらかたまり肉', '豚ばらブロック', '豚ばら肉', '豚ばら肉塊', '豚ひれ肉', '豚もも', '豚ももかたまり', '豚ももスライス', '豚ももブロック', '豚ももブロック肉', '豚もも肉', '豚もも肉ブロック', '豚もも薄切り', '豚もも薄切り肉', '豚カルビ', '豚コマ', '豚コマ肉', '豚スネ', '豚スペアリブ', '豚スライス', '豚スライス肉', '豚タン', '豚トロ', '豚ハツ', '豚バラ', '豚バラかたまり', '豚バラかたまり肉', '豚バラスライス', '豚バラブロック', '豚バラブロック肉', '豚バラ塊', '豚バラ塊肉', '豚バラ肉', '豚バラ肉かたまり', '豚バラ肉ブロック', '豚バラ肉塊', '豚バラ肉薄切り', '豚バラ薄切り', '豚バラ薄切り肉', '豚ヒレ', '豚ヒレブロック', '豚ヒレブロック肉', '豚ヒレ肉', '豚ブロック', '豚ブロック肉', '豚モモブロック', '豚モモ肉', '豚レバー', '豚ロース', '豚ロースかたまり', '豚ロースかたまり肉', '豚ローススライス', '豚ロースブロック', '豚ロース切り身', '豚ロース厚切り', '豚ロース厚切り肉', '豚ロース肉', '豚ロース薄切り', '豚ロース薄切り肉', '豚切り落とし', '豚切り落とし肉', '豚固まり肉', '豚塊肉', '豚小間', '豚小間切れ', '豚小間切れ肉', '豚小間肉', '豚細切れ', '豚細切れ肉', '豚肉かたまり', '豚肉こまぎれ', '豚肉こま切れ', '豚肉の薄切り', '豚肉ばら', '豚肉スライス', '豚肉ブロック', '豚肉ロース', '豚肉ロース薄切り', '豚肉切り落とし', '豚肉薄切り', '豚肩', '豚肩ロース', '豚肩ロースかたまり', '豚肩ロースかたまり肉', '豚肩ロースブロック', '豚肩ロース塊', '豚肩ロース肉', '豚薄切り', '豚薄切り肉', '豚足', '豚軟骨']
酒	['お酒', 'ホワイトリカー', '料理酒', '日本酒', '清酒', '紹興酒', '調理酒']
酢	['お酢', 'ぶどう酢', 'りんご酢', 'ハトムギ酢', 'バルサミコ酢', 'モルトビネガー', 'ワインビネガー', '合成酢', '大麦芽酢', '果実酢', '柿酢', '白ワインビネガー', '穀物酢', '米酢', '米黒酢', '粕酢', '赤ワインビネガー', '赤酢', '醋', '醸造酢', '食酢', '香醋', '麦芽酢', '黒酢']
酢の物	['すのもの', '酢のもの']
醤油	['うすくちしょうゆ', 'うすくちしょう油', 'うすくち醤油', 'うす塩しょうゆ', 'うす塩しょう油', 'うす塩醤油', 'おしょうゆ', 'おしょう油', 'お醤油', 'こいくちしょうゆ', 'こいくちしょう油', 'こいくち醤油', 'さいしこみしょうゆ', 'さいしこみしょう油', 'さいしこみ醤油', 'しょうゆ', 'しょう油', 'しょゆ', 'たまりしょうゆ', 'たまりしょう油', 'たまり醤油', 'だししょうゆ', 'だししょう油', 'だし醤油', '再仕込しょうゆ', '再仕込しょう油', '再仕込みしょうゆ', '再仕込みしょう油', '再仕込み醤油', '再仕込醤油', '出し醤油', '刺身しょうゆ', '刺身しょう油', '刺身醤油', '土佐しょうゆ', '土佐しょう油', '土佐醤油', '昆布しょうゆ', '昆布しょう油', '昆布醤油', '淡口しょうゆ', '淡口しょう油', '淡口醤油', '減塩しょうゆ', '減塩しょう油', '減塩醤油', '溜りしょうゆ', '溜りしょう油', '溜り醤油', '濃い口しょうゆ', '濃い口しょう油', '濃い口醤油', '濃口しょうゆ', '濃口しょう油', '濃口醤油', '白しょうゆ', '白しょう油', '白醤油', '薄口しょうゆ', '薄口しょう油', '薄口醤油']
里芋	['えぐいも', 'きょういも', 'さといも', 'どたれ', 'エビイモ', 'サトイモ', 'セレベス', 'セレベス芋', 'タケノコイモ', 'ヤツガシラ', '京芋', '八頭', '土垂', '海老芋', '石川早生', '筍芋', '赤目芋', '赤芽芋', '里いも']
里芋の煮物	['さといもの煮もの', 'さといもの煮物', 'サトイモの煮物', '里...', '里いもの煮物', '里芋の煮もの']
野沢菜	['のざわな', 'シンシュウナ', 'ノザワナ', '信州菜']
野菜スープ	['やさいスープ', '野菜スープ〜']
野菜炒め	['やさい炒め', '野菜炒め〜']
食塩	['あじ塩', 'あら塩', 'ゆず塩', 'アジシオ', 'アジ塩', 'アッケシソウ塩', 'ガーリックソルト', 'クレイジーソルト', 'クレイジーーソルト', 'クレジーソルト', 'クレソル', 'クレージーソルト', 'シーズンドソルト', 'ソルト', 'ハーブソルト', 'ハーブ塩', 'マジックソルト', '味塩', '塩', '天日塩', '天然塩', '岩塩', '粗塩', '自然塩', '藻塩']
餃子	['ぎょうざ', 'ぎょーざ', 'ギョウザ', 'ギョーザ', '水餃子']
餃子の皮	['ぎょうざの皮', 'ぎょうざ皮', 'ぎょーざの皮', 'ぎょーざ皮', 'ギョウザの皮', 'ギョウザ皮', 'ギョーザの皮', 'ギョーザ皮', '春巻きの皮', '春巻の皮', '餃子皮']
餅	['おもち', 'お餅', 'もち', 'モチ']
餡子	['あんこ', 'うぐいす餡', 'こしあん', 'こし餡', 'さらしあん', 'さらし餡', 'ずんだ', 'つぶあん', 'つぶしあん', 'つぶし餡', 'つぶ餡', '小倉あん', '小倉餡', '小豆あん', '小豆餡', '晒し餡', '晒餡', '漉し餡', '白あん', '白餡', '粒あん', '粒餡', '粒餡子', '緑豆餡', '練りあん', '赤あん', '赤餡', '餡', '黒あん']
高菜	['こぶたかな', 'こぶ高菜', 'たかな', 'まんば', 'タカナ', '万葉', '四川高菜', '辛子高菜', '青高菜']
高野豆腐	['こうや豆腐', 'コウヤ豆腐', '冷凍豆腐', '凍み豆腐', '凍り豆腐', '凍豆腐']
魚肉練り製品	['あげかま', 'かにかま', 'かにかまぼこ', 'かにカマ', 'かに風味かまぼこ', 'かまぼこ', 'さかなソーセージ', 'ささかま', 'さつまあげ', 'さつま揚げ', 'ちくわ', 'はんぺん', 'ひらてん', 'カニかま', 'カニかまぼこ', 'カニカマ', 'カニカマボコ', 'カニ風味かまぼこ', 'チクワ', 'ハンペン', '平天', '竹輪', '笹かま', '笹かまぼこ', '蒲鉾', '薩摩揚げ', '角てん', '角天', '魚ソーセージ', '魚ニソ', '魚肉ソーセージ']
鮭のホイル焼き	['さけのホイル焼き', 'しゃけのホイル焼き', 'サケのホイル焼き']
鯉	['こい', 'コイ']
鯵	['あじ', 'アジ', '小あじ', '小アジ', '小鯵', '小鰺', '豆あじ', '豆アジ', '豆鯵', '豆鰺', '鰺']
鰆	['さわら', 'サワラ']
鰹	['かつお', 'カツオ']
鱈	['すけそうだら', 'すけとうだら', 'たら', 'まだら', 'スケソウダラ', 'スケトウダラ', 'タラ', 'マダラ', '介党鱈', '助惣鱈', '真たら', '真鱈']
鳥肉	['うこっけい', 'かも肉', 'ささみ', 'ささ身', 'しゃも', 'せせり', 'とりささみ', 'とりむね肉', 'とりもも', 'とりもも肉', 'とりムネ肉', 'とりモモ肉', 'とり皮', 'とり肉', 'とり胸肉', 'ウコッケイ', 'カモ肉', 'ササミ', 'シャモ', 'チキン', 'トリムネ肉', 'ブロイラー', '丸鶏', '名古屋コーチン', '地鶏', '塩鶏', '手羽', '手羽もと', '手羽中', '手羽元', '手羽先', '烏骨鶏', '砂ずり', '砂ズリ', '砂肝', '笹身', '蒸し鶏', '軍鶏', '銘柄鳥', '骨付きチキン', '骨付き鶏もも肉', '骨付き鶏肉', '鳥', '鳥ささみ', '鳥のもも肉', '鳥むね肉', '鳥もも', '鳥もも肉', '鳥ムネ肉', '鳥モツ', '鳥モモ', '鳥モモ肉', '鳥レバー', '鳥手羽元', '鳥皮', '鳥胸肉', '鴨', '鴨肉', '鶏', '鶏ささみ', '鶏ささみ肉', '鶏ささ身', '鶏せせり', '鶏なんこつ', '鶏のささみ', '鶏のむね肉', '鶏のもも肉', '鶏のササミ', '鶏の手羽元', '鶏の手羽先', '鶏の皮', '鶏の胸肉', '鶏むね', '鶏むね肉', '鶏むね身', '鶏もも', '鶏もも肉', '鶏ササミ', '鶏ムネ', '鶏ムネ肉', '鶏モツ', '鶏モモ', '鶏モモ肉', '鶏レバー', '鶏手羽', '鶏手羽もと', '鶏手羽中', '鶏手羽元', '鶏手羽元肉', '鶏手羽先', '鶏手羽肉', '鶏皮', '鶏砂肝', '鶏笹身', '鶏肉', '鶏肉の皮', '鶏肉もも', '鶏肝', '鶏胸', '鶏胸ひき肉', '鶏胸肉', '鶏腿肉', '鶏軟骨', '鶏骨付きもも肉']
鶏がらスープの素	['がらスープ', 'がら顆粒', 'ほたてだし', 'ほたてダシ', 'ほたて出汁', 'ウェイバー', 'ウェイパァ', 'ウェイパー', 'ウエイバー', 'ウエイパァー', 'ウエイパー', 'ウエイファー', 'ウエイーパー', 'ウエーパー', 'ガラスープ', 'ガラ顆粒', 'シャンウェイ', 'チキンストック', 'トリがらスープ', 'ホタテだし', 'ホタテダシ', 'ホタテ出汁', '中華だし', '中華スープのもと', '中華スープの素', '中華ダシ', '中華出汁', '中華味ベース', '中華顆粒出し', '味覇', '帆立だし', '帆立ダシ', '帆立出汁', '顆粒鳥がら', '顆粒鳥ガラ', '顆粒鶏がら', '顆粒鶏ガラ', '香味', '鳥がらスープ', '鳥がらスープのもと', '鳥がらスープの素', '鳥ガラスープ', '鳥ガラスープのもと', '鳥ガラスープの素', '鶏がらスープ', '鶏がらスープのもと', '鶏ガラスープ', '鶏ガラスープのもと', '鶏ガラスープの素', '鶏ガラダシ']
鶏の唐揚げ	['鶏のからあげ', '鶏のから揚げ', '鶏の空揚げ']
鶏の照り焼き	['鶏のてりやき', '鶏の照焼き']
麩	['あぶら麩', 'うずまき麩', 'おつゆ麩', 'お麩', 'すだれ麩', 'もち麩', '丁子麩', '仙台麩', '小町麩', '庄内麩', '手まり麩', '板麩', '棒麩', '油麩', '焼き麩', '生麩', '白玉麩', '花麩', '角麩', '車麩']
麻婆茄子	['麻婆なす', '麻婆ナス']
麻婆豆腐の素	['麻婆豆腐のもと']
エビフライ	['海老フライ', 'えびフライ']
アジフライ	['あじフライ', '鯵フライ']
カキフライ	['牡蠣フライ', 'かきフライ']
ます寿司	['鱒寿司', '鱒寿し', 'マス寿司', '鱒ずし']
かつ丼	['カツ丼']
